##########
#        #
#        #
##       #
#        #
#    #   #
##       #
#  #    ##
#     @  #
##########