






 ###############################
 #             *        **    e#
 # @                          e#
 #####    #####    #####    ####
 ##### ^^ ##### ^^ ##### ^^ ####
 #####....#####....#####....####
 #####::::#####::::#####::::####
 ###############################




















































































