##########
#e*      #
#  <     #
##      *#
#*       #
#    #   #
##      @#
#..#....##
#::::::::#
##########